{
  "name": "test",
  "tile-width": 10,
  "tile-height": 10,
  "layers": [
    {
      "layer-id": 1,
      "layer-name": "layer 1",
      "type": "tile-set",
      "tile-set": "textures/tileset.gif",
      "data": [
        [37, 38, 38, 38, 38, 38, 39, 41, 41, 25],
        [55, 56, 2, 3, 56, 2, 75, 41, 41, 42],
        [73, 3, 20, 21, 56, 20, 39, 41, 25, 60],
        [41, 55, 56, 56, 56, 56, 57, 41, 42, 5],
        [41, 55, 56, 56, 2, 3, 57, 41, 42, 5],
        [41, 55, 2, 3, 20, 21, 57, 41, 43, 24],
        [41, 55, 20, 21, 56, 2, 75, 41, 41, 42],
        [37, 21, 56, 56, 2, 75, 41, 41, 41, 42],
        [55, 56, 56, 2, 75, 41, 41, 41, 25, 60],
        [73, 74, 74, 75, 41, 41, 41, 41, 42, 6]
      ]
    },
    {
      "layer-id": 2,
      "layer-name": "obj layer",
      "type": "object",
      "data": [
        [0, 0, 0, 0, 0, 0, 0, 0, 0, 0],
        [0, 0, 0, 0, 0, 0, 0, 0, 0, 0],
        [0, 0, 0, 0, 0, 0, 0, 0, 0, 0],
        [0, 0, 0, 0, 0, 0, 0, 0, 0, 0],
        [0, 0, 0, 0, 0, 0, 0, 0, 0, 0],
        [0, 0, 0, 0, 0, 0, 0, 0, 0, 0],
        [0, 0, 0, 0, 0, 0, 0, 0, 0, 0],
        [0, 0, 0, 0, 0, 0, 0, 0, 0, 0],
        [0, 0, 0, 0, 0, 0, 0, 0, 0, 0],
        [0, 0, 0, 0, 0, 0, 0, 0, 0, 0]
      ]
    },
    {
      "layer-id": 3,
      "layer-name": "layer 2",
      "type": "tile-seft",
      "tile-set": "textures/tileset.gif",
      "data": [
        [0, 0, 0, 0, 0, 0, 0, 0, 0, 0],
        [0, 0, 0, 0, 0, 0, 0, 0, 0, 0],
        [0, 0, 0, 0, 67, 0, 0, 0, 0, 0],
        [0, 0, 68, 69, 0, 0, 0, 0, 0, 0],
        [0, 0, 86, 87, 0, 0, 0, 0, 0, 14],
        [0, 0, 0, 0, 0, 0, 0, 0, 0, 0],
        [0, 0, 0, 0, 0, 0, 0, 0, 0, 0],
        [0, 0, 0, 0, 0, 0, 0, 0, 0, 0],
        [0, 0, 67, 0, 0, 0, 0, 14, 0, 0],
        [0, 0, 0, 0, 0, 0, 0, 0, 0, 0]
      ]
    }
  ]
}

